ob,ob,ob,ob,ob,ob,ob,ob,ob,ob,ob,ob,ob,ob,ob
ob,g,g,r,r,r,r,r,r,r,r,r,g,g,ob
ob,g,b,r,r,r,r,r,r,r,r,r,b,g,ob
ob,r,r,r,r,r,r,r,r,r,r,r,r,r,ob
ob,r,r,r,r,r,r,r,r,r,r,r,r,r,ob
ob,r,r,r,r,r,r,r,r,r,r,r,r,r,ob
ob,r,r,r,r,r,r,r,r,r,r,r,r,r,ob
ob,r,r,r,r,r,r,r,r,r,r,r,r,r,ob
ob,g,b,r,r,r,r,r,r,r,r,r,b,g,ob
ob,g,g,r,r,r,r,r,r,r,r,r,g,g,ob
ob,ob,ob,ob,ob,ob,ob,ob,ob,ob,ob,ob,ob,ob,ob
